NO ./path_to_the_north_texture
SO ./path_to_the_south_texture
WE ./path_to_the_west_texture
EA ./path_to_the_east_texture








F 260,100,0,250
C 225,30,0

111     1111111111111111111111111
101     1000000000110000000000001
111     1011000001110000000000001
        1001000000000000000000001
111111111011000001110000000000001
100000000011000001110111111111111
11110111111111011100000010001
11110111111111011101010010001
11000011100101011100000010001
100001   10000001100000010001
10000011100000001101010010001
11000000100101011111011110N0111
11110111 1110101 101111010001
11111111 1111111 111111111111